20
10
   +---+---+---+---+---+---+---+---+---+---+
 19| 0 | 0 | 0 | 0 | 0 | 0 | 0 | 0 | 0 | 0 |
   +---+---+---+---+---+---+---+---+---+---+
 18| 0 | 3 | 3 | 3 | 3 | 3 | 3 | 3 | 3 | 3 |
   +---+---+---+---+---+---+---+---+---+---+
 17| 0 | 3 | 1 | 1 | 1 | 1 | 3 | 1 | 1 | 3 |
   +---+---+---+---+---+---+---+---+---+---+
 16| 0 | 3 | 1 | 3 | 3 | 1 | 3 | 1 | 3 | 3 |
   +---+---+---+---+---+---+---+---+---+---+
 15| 0 | 3 | 1 | 1 | 3 | 1 | 3 | 1 | 1 | 3 |
   +---+---+---+---+---+---+---+---+---+---+
 14| 0 | 3 | 1 | 1 | 1 | 1 | 1 | 1 | 1 | 3 |
   +---+---+---+---+---+---+---+---+---+---+
 13| 0 | 3 | 1 | 3 | 3 | 1 | 3 | 1 | 1 | 3 |
   +---+---+---+---+---+---+---+---+---+---+
 12| 0 | 3 | 1 | 3 | 2 | 1 | 3 | 1 | 1 | 3 |
   +---+---+---+---+---+---+---+---+---+---+
 11| 0 | 3 | 1 | 3 | 3 | 1 | 3 | 1 | 3 | 3 |
   +---+---+---+---+---+---+---+---+---+---+
 10| 0 | 3 | 1 | 2 | 3 | 1 | 3 | 2 | 2 | 3 |
   +---+---+---+---+---+---+---+---+---+---+
  9| 0 | 3 | 1 | 2 | 1 | 1 | 3 | 1 | 1 | 3 |
   +---+---+---+---+---+---+---+---+---+---+
  8| 0 | 3 | 1 | 1 | 1 | 1 | 3 | 1 | 1 | 3 |
   +---+---+---+---+---+---+---+---+---+---+
  7| 0 | 3 | 3 | 3 | 3 | 3 | 3 | 3 | 3 | 3 |
   +---+---+---+---+---+---+---+---+---+---+
  6| 0 | 0 | 0 | 0 | 0 | 0 | 0 | 0 | 0 | 0 |
   +---+---+---+---+---+---+---+---+---+---+
  5| 0 | 0 | 0 | 0 | 0 | 0 | 0 | 0 | 0 | 0 |
   +---+---+---+---+---+---+---+---+---+---+
  4| 0 | 0 | 0 | 0 | 0 | 0 | 0 | 0 | 0 | 0 |
   +---+---+---+---+---+---+---+---+---+---+
  3| 0 | 0 | 0 | 0 | 0 | 0 | 0 | 0 | 0 | 0 |
   +---+---+---+---+---+---+---+---+---+---+
  2| 0 | 0 | 0 | 0 | 0 | 0 | 0 | 0 | 0 | 0 |
   +---+---+---+---+---+---+---+---+---+---+
  1| 0 | 0 | 0 | 0 | 0 | 0 | 0 | 0 | 0 | 0 |
   +---+---+---+---+---+---+---+---+---+---+
  0| 0 | 0 | 0 | 0 | 0 | 0 | 0 | 0 | 0 | 0 |
   +---+---+---+---+---+---+---+---+---+---+
     0   1   2   3   4   5   6   7   8   9
2
17
N
302
2
8
