20
10
   +---+---+---+---+---+---+---+---+---+---+
 19| 0 | 0 | 0 | 0 | 0 | 0 | 0 | 0 | 0 | 0 |
   +---+---+---+---+---+---+---+---+---+---+
 18| 3 | 3 | 3 | 3 | 3 | 3 | 3 | 3 | 3 | 0 |
   +---+---+---+---+---+---+---+---+---+---+
 17| 3 | 1 | 1 | 1 | 1 | 3 | 1 | 1 | 3 | 0 |
   +---+---+---+---+---+---+---+---+---+---+
 16| 3 | 1 | 3 | 3 | 1 | 3 | 1 | 3 | 3 | 0 |
   +---+---+---+---+---+---+---+---+---+---+
 15| 3 | 1 | 1 | 3 | 1 | 3 | 1 | 1 | 3 | 0 |
   +---+---+---+---+---+---+---+---+---+---+
 14| 3 | 1 | 1 | 1 | 1 | 1 | 1 | 1 | 3 | 0 |
   +---+---+---+---+---+---+---+---+---+---+
 13| 3 | 1 | 3 | 3 | 1 | 3 | 1 | 1 | 3 | 0 |
   +---+---+---+---+---+---+---+---+---+---+
 12| 3 | 1 | 3 | 2 | 1 | 3 | 1 | 1 | 3 | 0 |
   +---+---+---+---+---+---+---+---+---+---+
 11| 3 | 1 | 3 | 3 | 1 | 3 | 1 | 3 | 3 | 0 |
   +---+---+---+---+---+---+---+---+---+---+
 10| 3 | 1 | 2 | 3 | 1 | 3 | 2 | 2 | 3 | 0 |
   +---+---+---+---+---+---+---+---+---+---+
  9| 3 | 1 | 2 | 1 | 1 | 3 | 1 | 1 | 3 | 0 |
   +---+---+---+---+---+---+---+---+---+---+
  8| 3 | 1 | 1 | 1 | 1 | 3 | 1 | 1 | 3 | 0 |
   +---+---+---+---+---+---+---+---+---+---+
  7| 3 | 3 | 3 | 3 | 3 | 3 | 3 | 3 | 3 | 0 |
   +---+---+---+---+---+---+---+---+---+---+
  6| 0 | 0 | 0 | 0 | 0 | 0 | 0 | 0 | 0 | 0 |
   +---+---+---+---+---+---+---+---+---+---+
  5| 0 | 0 | 0 | 0 | 0 | 0 | 0 | 0 | 0 | 0 |
   +---+---+---+---+---+---+---+---+---+---+
  4| 0 | 0 | 0 | 0 | 0 | 0 | 0 | 0 | 0 | 0 |
   +---+---+---+---+---+---+---+---+---+---+
  3| 0 | 0 | 0 | 0 | 0 | 0 | 0 | 0 | 0 | 0 |
   +---+---+---+---+---+---+---+---+---+---+
  2| 0 | 0 | 0 | 0 | 0 | 0 | 0 | 0 | 0 | 0 |
   +---+---+---+---+---+---+---+---+---+---+
  1| 0 | 0 | 0 | 0 | 0 | 0 | 0 | 0 | 0 | 0 |
   +---+---+---+---+---+---+---+---+---+---+
  0| 0 | 0 | 0 | 0 | 0 | 0 | 0 | 0 | 0 | 0 |
   +---+---+---+---+---+---+---+---+---+---+
     0   1   2   3   4   5   6   7   8   9
1
17
N
326
1
8
